+--+--+--+--+--+--+--+--+--+--+--+--+--+--+--+--+--+--+--+--+
|                                                           |
|  +--+--+  +--+--+--+  +--+--+--+  +--+--+--+  +--+--+--+  | 
|  |     |  |        |  |        |  |        |  |           | 
|  |  M  |  |  +--+  +--+  +--+  +--+  +--+  |  |  +--+--+  | 
|  |     |  |  |     |     |  |     |  |  |  |  |  |        | 
|  +-- --+  |  |  +--+  +--+  |  M  |  +--+  |  +--+  +--+  | 
|           |  |  |     |     |     |        |        |     | 
|  +--+--+--+  |  +--+  |  +--+--+  +--+--+--+--+--+  |  +--+ 
|  |        |  |        |                             |  |  | 
|  |  +--+  |  +--+--+--+--+--+--+  +--+--+--+--+  +--+  |  | 
|  |  |  |  |                    |  |           |  |     |  | 
|  +--+  |  +--+  +--+--+--+--+  |  |  +--+--+  |  |  +--+  | 
|        |        |           |  |  |  |     |  |  |  |     | 
|  +--+--+--+--+  |  M  +--+  |  |  +--+  +--+  |  +--+  +- |
|  |           |  |     |  |  |  |        |     |        |  | 
|  |  +--+--+  |  +--+--+  |  |  +--+--+--+  +--+--+--+--+  | 
|  |        |  |           |  |                             | 
|  +--+--+  |  +--+--+--+--+  +--+--+--+--+--+--+--+--+--+  | 
|        |  |                                               | 
+--+--+  |  +--+--+--+--+--+--+--+--+--+--+--+--+--+--+--+  | 
|        |                                                  | 
|  +--+--+--+--+--+--+--+--+--+--+--+--+--+--+--+--+--+--+  | 
|                                                           g| 
+--+--+--+--+--+--+--+--+--+--+--+--+--+--+--+--+--+--+--+--+